*******************************************************************
*...........**....*****...*...******...***......**......***********
*......***........*****...*...*******.........***........**********
*.....*****...**..*****......**********.....***..........**********
*.....**.**.......****..***...***.***.......**............*********
*......*..*......****........****.***......***........*************
***......****..........********...***.....>..***.......************
***....*..****...***....******....***.......****..***..*.**********
**........****.........*******....***.............***.....*********
*.*........****..**.....***.***...***.......**...*.****************
*......*********.*.....**........****...***.*.......***************
*......*********....****.........**.....**...........*....*********
*...**......*.**.*.....*.***.....**.....****...*...........**....**
*..***.....**.*..*.......***.....**....****...**........*.**......*
*.***......**.....***............**...*****....**.*.....**....*****
*..*.......**<..........*......***.......**.....*.****.*.....***.**
*.***.....*...........***...............***.......****...*.......**
*..***....*.....*.....**.................***......****...*....*.***
*..****....**.....*...****.....*.........**.*.......*....***.....**
*....***...**...*.***...**...***.........................*........*
*....****..***....***...***..***...***......******..........*.....*
*..*...***.***.....***.*.....***.....*......*****...........*.....*
**.....***.***.*...*.***.*.*.***...******..***.***.....*....**.*.**
**.*....****.*...........*.*****..**********...***...............**
**.*....***...............****.....**.******....***............**.*
**.*....***..*...........*******.*.......***....***.*******.......*
**..*...***...*..........*******.*..*...**.*.******......***......*
*****.*.*.........**.****....*****.**...*........*.......****.....*
****..*.*..........*....*.*..***......*****......*.........****...*
****.***...........*....*.*...*....*...***.*.....*.*.....*..****..*
***...**.....*........*.*****........***...........*...***...**...*
*....***..............*****......................***.******...*...*
**...***...............****.......................**.*.****.......*
*......**..........*...***...*.........................****.*.....*
***.....**.......*.***.*.*.********.*..........*.......*....***...*
***.....**......******.*....*****...*.....**....*......*......***.*
***....*******...*****....*.*****....**...**....*....******..******
*******************************************************************
