*******************************************************************
*....**.........******.........**.*....***.**.....****.......******
*......****...*...**................**.*.*..*....****......********
*.......***.****..**..............*.***.....***....***....****.****
*.......*....****.**.....*........**.*.......**..........*****..***
*.....*.....*.******............****.......*****.....*.******...***
*.............**********........*******.....***........*******...**
*.......*.*...*...****............*****.....**.....*...*.*........*
*.......*.............***....*....*****......*...*.......*...**...*
*.**..******........**...*.*.****....*...........*................*
*....*...............*...***...*.....*...................*.*......*
*...................**....***.**.............................*....*
*..........................****....**....*...........**.......*...*
***............***..........****...***..**.....*..*....*..*.......*
*.*......**...********......****....**..*...*.....*.....*.**....*.*
*........**...********....**..*.....**...*****..***.....*.*.......*
*.......*.....***..****..**........**............**......**.*.....*
*...................**...**...................*...**...*****......*
*.....*..............*.*.*.........*...***.................**.....*
*...***..............*...***..........****...**......*.....**..**.*
*...*....**.........**.....**........**.....***.............*.....*
*.......*...*....*.***.....*.........*....*...**...............*..*
*......*******.....*****...*.......**********.****....*....*.**...*
*....***.*****.....*******....*....*********...****........**.....*
*....***.***...*..********...***..******.*.....***.........**.....*
*....***...*............*....*.*....****........****......****...**
*.....**...**.....*.....*....*....*....*.*.******..**.....******.**
*.*.*.**...**...***..........*....*...****.******.........*********
*...*.**....*.****..........**....*....***.*******.*.......********
*...**......******..........*...........*************............**
*...**..........****......***............**......****...........***
**.****...........**.****..**............**.......***....**....****
*..*******........**..**...*.............**.........***************
*..**********...***........*.......*......*...**....**.************
*......******...****...............*...*....****.......************
**.*.*.******...**.....*.**...........***....***........***********
**.*....*****.................***....**......*...........**********
*******************************************************************
