*******************************************************************
*****..*.*****.*.................................******************
*****..*....*..........***...........*.....*.....******************
*****.......*..*.***.*****.......*.......******.*******************
*****...........****..****.....****.*.*****************************
*******...*....******...**..**......*****.*************************
***********.**.****.*...**..***.********....***********************
****************............***..*...***.*..***********************
***************.....**......***.**...***.....**********************
************...*....*.*....****.......***....**********************
*.*...****.*..***.....*.*......***........*...*********************
*...******.*...******...*....******.....**....*********************
*...*......*....******.........****.....***...*********************
*..***...........******.*......**....*....*.....**...**.*.*********
**.**...............***.*......*................**.........********
*..**............*****.......................**......*.....***..***
*.....*......<.*.*...***.....................***.....*********.****
**..****.....*.****...**..**....*.............*...****.*****....***
**...**........***....*******..........................******.....*
**...*........*.***...******....*.....**................**..***...*
***.........*.*...***...***...........***...***......*****....*...*
****...............**...****..***...*****.............*****.......*
****.**.......***..**.........**...******.*...........*****.......*
**...*.........*.*....***...****....***.*.*.........*...*.**......*
**...***.............***....***....*.*...**.......***...*.**......*
**...*............*****...****.......*...**.*.....*****...........*
***..***...........***....*****..*..*.....***.....*......*........*
*.........*........***...*********..**....*.*...*..>.........****.*
*..*......*..........**************...*........**.............***.*
*****....*....*.*......***...**..**..****.......*.*...........***.*
********........**......**............***....*..***.*.....*.....***
**********.***....*....*.......***..*****........**......*...*.****
*********....*......*..........***...****........**......*...*.****
**********...........***...*...**...***................***........*
**********.***.......***...*...*..........*........*...****...**..*
**************.*......**.*.....*...**......*.**....*..*****.......*
***************.......***...**.*...****...........*....***...***..*
*******************************************************************
