*******************************************************************
*.*.***.........***....***......***........****......***..*********
*....**.......*...*.............***..*.*...*.***.*....**..*********
*....*........*...*.............**...*.....*.***.*.....*..*********
*....*....*.*.*.*.*.........**.......***.*.*.*****....**.******...*
*......***..***.***.......***...*...***......**.**.*.**...*.......*
*.......*.....*.*****....***....*...**...*......***..**...*.**...**
**.....**....**..........****.****.***....................*.......*
*..*.*.*...*****..........****......**..................*.*..*.*.**
*......*.*****......*.*.*...........**........*.........****......*
*......*******......**........................***.........***..*..*
*....***...***..........*.....................***...*.............*
*******.....***..**...*.....**.**...........*.**..*.*......******.*
*******.....**...**.....*....*****....*.......*...***...*******...*
*...***.....*.....*...***....*****..*...*.....**...****.*****.....*
**...**...*............**...****.*.**.........**...******..**.....*
*....**....*...**......********..............***...****.....*.....*
****..*...**...***..********.........*...*...***...****.....****..*
*..*.****.*....***....******.........****...***.....*.........**..*
*..*.**...**...**...*****.*....*.............**....****......****.*
*....**.*.**......*******.....***.................****...***..**..*
*..........**...********........***...............****...****..*..*
*..........***..**********.**....***...*..........*********.*..*..*
*...........*.**********...*....********..........********.....**.*
*.***............***********..*.*...*****....**...****.**.........*
*.*.**........*.*****************....****.*.***.....*......*......*
*...**.....****..*************........*.*......*.......*....**..***
*..***.....****.*************.................**....*.......**...**
*******....***....***********.....*....*......**......*......******
******.*.*..**......****.****.....**.*.....*..**...**.......*******
******.*.....*......**...******...**......**..***..***..***********
*****..*............***..***.**...............***..***..***********
*........*...*...*.***...*............***.....***.****..***********
*........**.......****........*...*...****....*...****....*********
*.*....****.......**........*.*.****.******..***.*****.....********
***....***........***.....********......****.....******....********
****...**.......*****.......******.......***.*...******.*...*******
*******************************************************************
