*******************************************************************
*..*...*.....*.......*..........*......**......*.......************
*....***.*..........*.........******...........*......*************
*.....****.*..........*.....********..***.............*************
****.....***.......*..***...********..***.............***.........*
***......***......*...****.......*.*...**...........**.****.......*
*.........***.**..*******........*.**.....<........**....***...*..*
*.*...*...**..******...**.....................*.*.***....******..**
*.*****....**.*.****.*.**.......*.......***...*******.....*...*...*
*******...***...****....*.......**.....****...*...*.*....**...*...*
****......**....****..***......****....***...**..........**...*.***
****....***...******.*.**......***..........***....*...*.**.....***
*..*.*....*....*****.*.**...*******.........*****......*..**.....**
*.**..........*.****.*......*.*****...*.....***.*.........**....***
*.............*.*.....***...*.********......*.......**....**.....**
****........***...**....*...*...*****......*........**..........***
*.*........****....*........*....****.*...*........***..**.......**
*.*.*......****.....*..............*********.*.....**............**
*...........*.*......**.....**.....******........................**
*.*.....**...........**.....****...***.......**.................***
*.......**............*....*****...***..........................***
*......**.............*.....****...*....***.....**.*...........****
*.....................*...*****.........**.........*..........*****
*.....**......******..*******.....*.....**.......**...***...***.***
*.............******......***..**...*.***..*.....***..***...***..**
**.***........******...**......*....******.*.....*******.....**...*
******.........*.....*.******..****...*..***.......*....**........*
******........>....********...**..***....**........**...**...*..***
****...**............*******.............**.......***....*...*..***
*..*...***.......**********..............*........***........*.****
*......***.........*......*....*....*....*....**..*..........******
**.....***....****....*...........***....*....**.............******
******...................................*..........****.....****.*
******..*...............................*....*......*..**....***..*
******............*..........**.......**.....................***..*
*******......***..*...*.....*.......******............*...........*
******..............***....*......*******........*.*..**..........*
*******************************************************************
