*******************************************************************
*.......***.....***....*......**********...*......**..***.....*...*
*....<.*****....**.......*.....***..***....**.........***.........*
*.*.*..*****...........*****...***..***...***....**........**...*.*
*.***..******.......*.****.........****..........*.........**.....*
*..**..****......*..*.**.*.........*****....***..*...**.*.****...**
*****..**......****...*.......**..*****....***.*........*.****.****
*......*.......***..*.**......*.***.*...*..**.........***.****.****
*..........*..***...**........*.........*.............***..***.****
*..........*****....**...***...........**......**....****..********
**..................**.............*....*.*....***...**************
**..****............**.*..........**...*..*.....***...***.*****...*
*..***.........*....**.*.***.......*****.........*........***.....*
*..***.....*..***..*.*.....******..***.......*.*......*...******..*
******....**..****....*.....*****...........****...........******.*
*****..........*......*......**.*..*.*.......***........*.***.....*
*****..........**.....*****........*.*...........*..*............**
****...........*......**..*......***................**....****..***
**................*....*.**.......*..*....***.***...***...*..******
*................**......*........*...**..***.***....**...*..******
*.........**.....***.....**...........*...******......**.....*..***
*.........**.........*..***.***..........>.***........**....*...***
*.*.......**..........*.*******.............**........**......*****
*..*...*.****.........*.....***....**.*...***..........*......*****
*...*....****.*.......***...***....****...**...................****
*...***...******...******.*.***.......******..........*.........***
*...**.....**.****.************.*...**...*..................*...***
*...**....*......*.*.***.**....*....**...**..*.......*..........***
*..*...........*.............****...**....*****.***.**.......******
*****.*........*.....................*.......******..*.........****
*******....*..**..*.........***.............*******........***....*
****.*...**.......*........****......***....*****.*.**.....**...*.*
***......**...*...*........****......*.*......***...****...***....*
**.......*...**...*........****....*...*.**.......*.****...*...****
****.*...........***......***......***...*....*.***.****...**...***
**...*.............*...****.......**.....*.**....******....********
*..*...................*****.....**.......***.....******........***
*******************************************************************
