*******************************************************************
*...*****......**...*....***..............*..***...****..*.********
*....*****.*.......**...***...........*..**...***........*.********
*.....******..*...***...*.*..........*.....*...**........*.********
**.....********...**....*...*.........*......****..**......********
***..<.***....**...*..***............******..****..****.....*******
***...**......**...*.****........*....*.**..****...******...*******
***...**..........*..****........**.....*******....****...*......**
***..*.*.....*...*...****..........*......*****.....***...***.*...*
*..........**...**.............**.....*..*****......*.....****....*
*....*.....***.......*........*...........****..**........*****..**
*...***.....*.****...**.......***..............***...****.....*.***
*...****......**...***...........**.............*********..*.*.****
*..*****......*****************.***...*......*...*.*******.*.*...**
*.**.*.........******..*******..****..*..*..........******........*
****...........***..*.**************...***..........***........**.*
*.....................***************...**....**...****.........*.*
*.......*....**.....***********.*****....*.*.***..*****....*.****.*
*..*..*.*....**..************.....****...*.*************...*****..*
********.......*.************....***...**..***.******.**..*********
**.***...........************......*..****.***.....*...*.**********
*..................********.***....****....*****...***.************
*......****.........*.****...***.*****....***..........************
*.......**................**.*...**..**....**...*.....*************
**.*....**.............**........**...................*************
****............**.......*..............**.........****************
***..*.................................***.........****************
***........*........*.*....**.........****.........****************
*...*.*.**.*.......**.*...****..........****.......*.*******..*****
*.....*.**...*........*...******....*...***..........*******....***
***...****.......*...***********...**...**..........********.....**
**...*****...***.*...*********....*...*.......*.......*******.....*
*....*****...***.....********.....*...........***.....*******...***
*....******........*.*....*.......*...*........**.......*****...***
*..********..........*.......**..*....*....***.**.*.......*.....***
***********......*****.......**.*....***..>.**....***...........***
********.....*****.....**......****..****..**************.*.....***
*******************************************************************
