*******************************************************************
*....******.*..*...*..*.*.***......*.*************......******....*
*...******............*.*.*.**...*.*..**..****...*...*....****..*.*
*...******...........**.*...*......*......**.*...*........**....***
*...*****.............*.*....................*............*.....***
*..***...****.....*****....................*....***.......**....***
*....*.*.....****..*.......................*....***...*....**...***
*.........*...***.............**...........*....**........***.....*
*....**.......*****...**....*.........***........**..........**...*
*.....*....................***........*...*.**..*........*........*
*...*........***......***..***...*....*...*******...**............*
*.**..........**......************........***.......***...*.*.....*
****.......******.....*****....***.........****....******...***...*
*.....**...****...********....****.............**....*.*..........*
*.....***..***...********....*****............***..**..*.....*.**.*
*......*..........******.....***.............*****................*
*.**........*....****..*....**.**...*...***********.......*.....*.*
*.**.*...*...*...**......*......**..*....**********.......*.......*
*....***...**....*......***.....****..*************........*.....**
*....****.........*.....***......***..**************.......*......*
*....****.......***....**.....*...**.**************.............***
**...****.......*......**..****...*...****...*****....*.***.....***
**....*..........**************...********...***........*.........*
*....*.............**...**.**...*..****......*................*...*
*..................**.*.**.*........***......*.*..................*
*.........*.........*...............*.*........*...*.....*.....*..*
*........**.........*....*....**...................*...*.*........*
*.......***.*.<....*...*.*....***..**.....***..........*.*........*
**.*.*.*****.......*...***.....*...........***.........*..........*
*..*.****....*.....******................********......*......*****
*..*.**......*......*****....*.............****..*.............****
*.****...*****.......**.....****...........***...****.....*....****
*.***....*****.......**.....***....................**.*...*....****
*****...***..*...*...***....***...............***...*.........*****
****.............*.......******.......*......****...**.***..*******
***.*....*...**..........******.......*.*........*****...*...******
*........******......*....****..........*........****..*.*....*****
*******************************************************************
