*******************************************************************
*..........***...*********.....*....*********..............*.....**
*...........**...*********......*...*********.........********...**
*..........***....*******...........*****..******....*****.*....***
*..........*****...****..*...........*****....**.....***....*...***
*.*.***...******...*....****.........*****....***....***.*.***....*
*.*.*........*****.........***.........*.*....***....***.*..**....*
*.*.*..............*.**.............................*.***...*.....*
*.*.*..........*....***........**..**..***..........*.*.....**....*
*........*..........**.......****..**..**.....*...*...*...........*
*........***.................**........**.....*..**...***....*....*
*........***........*....**...................**......*****..*....*
*........*****....*.**...***.....*....*.................***.**....*
*....*.*.*.*......*.***..***....***...*.......*.........**........*
**...***.*...*...****....****...**.....*..........*.............***
****.....................*********....**..........**...**.......***
****............***......*****.....******.......****.*******....***
***........**...**.........*....*.*....***..****************....***
***...*...***.****................*.*........****************...***
**...****...**..***...........**..*.**........*********************
**...****....**...**...**....****.*.*.*.......*********************
**.******...***....*.*.......*.****...*.......*********************
*******......***.*.*.*.........*********...************************
****.***.***.*****...*....*...*...***..*...************************
****.*...*.....*****.******..**.......*******.*********************
*.*...............*...******......*...******...********************
*...............**....*****.........*******.....*******************
*...............**.....*.**......**......*......*******************
**.....***...*..****.*...**.**....***............******************
**...****......*********.*..**..*****...........*******************
*.........********....**...***...****...........*******************
*........**....***.*****....*....*****.*..**....*******************
*...*........*****....***...***...*****...**...********************
*.............****....***.......*********..*...********************
*...******....*****...***....*.****.***.......*********************
*.....******..****...*****...*.***........*..**********************
*...*********.........*****..*.**...........***********************
*******************************************************************
