*******************************************************************
******...*......*****.*......**..............***...***.************
******............*....*....***..................***.*.************
*******...............***....***.........***.*.........************
*****.....*...**...*.****....***.........***.*......*.*************
****..........**....******...............*.*.......**.*************
****....***..***..*******...*................*..*******************
****...***...***..**..*****.............*......********************
****...***..*******...**......****....***...*.*****.***************
*****.****...******...***.............**........**....*..**********
**********.....*......***<..**...***.***......*.*.......***********
************..........***...*..*.*****.*.*....**........***********
************.*........***...*..*******...**....*......*************
***************.......***...****.*****...**......*....*************
*********.*****...*...***...***.....**...**...*.......*************
***************......****...***.*...**.....*.*.......*********.****
*************.....****..***...***...*......**......*....******..***
********.**....*.***.....**.*...*........**......*...............**
********.***...******.......***.........***....**................**
***.****......******.........**...***...*****.***................**
*..........******.**.......****...***.*..*****..............*.*****
*...........*****..***.....*.*...***.....****.................*****
*...........*..**..........*.*...........**.........*............**
**.....****........***.....*....**......***.*..................*.**
***...*..........**********.....*.......*.......**................*
***...*.....***...******........................***...**..........*
***..**........**********.......................**....***.........*
***...*.....**..********...*.*................*****...***.*....**.*
****..**....**...**........*......*.........********..*****....**.*
****..***...**....******..........*..........***..*********....****
*****.......**........*****....****.......**...*...****........****
****......******....*******.....***....****....**...****.......****
***......***.****....*...***....***.......**..***....****...*******
*...*.*.*....*******.....***....***..**...****.***....****..*******
**.**.*......*******.*..*****...*****......***.......******.*******
*..*.......************************........***...**....************
******...*************************..*............*.......**********
*******************************************************************
