*******************************************************************
*********.......**********....******...............******...*******
*********.****..***********...*...****............********.....****
*******......*...**********........***......*.........****.....****
*****......***...********.**.......****....****......****...*.....*
**.........***....*..***..**........***...***...........*...*.....*
***.......*****..**........*.*...*........*...****......*****.....*
*******..**.<....****.*....*.....*...*..........***....*****......*
*******...**...******..*....**...*.*...........***.....*****......*
******.*......**.*.....***..**.......*........****...*............*
******.....***...*.....***..***..............*..........*.***...***
******......***........****.****....***.***.......*...*.*.***.....*
*******...***...****..****...*..*...******........*.....*...****..*
*...****..*.*.*.*.**..*..***..........***............*.....******.*
*.....*.......*.*.**...*....*.........***..........***......*******
*...*.........***.****.*..............*...**...*...***.......***..*
*.*.*..*...*.***....***...*......****....****..*.*...***.....***..*
*...**.....*.**......**.***...*.***...*...***.......*****.**..**..*
*....*.*.*.*.*.......*...**......**...****........*.*****.***.....*
*....*...***.**......***.**......*............*...*****....**..*.**
**.......***..****...*........................*...****......*....**
**.......****...*...........**....*****........*.******..........**
**........**....**........*.*.*...*****.........****.**...........*
**......******.......**...**......****...........*..........*.....*
**......***....*.*..***....*...**..**...**.*******........*.*....**
***....****...*...*.****.......******..*.********.........****..***
**.......***.........****....********....*******.........******.***
***.....*****...**.*******..**********...*...**....*....***********
*......******....*..*******...*******.......***.........***********
*.....********...*..........********...**....**....*.....**********
*....*..******...*..........*********..***...*............*********
**...*....*.*...**..........*****......***...*....*..*.************
****........*.*..............******....***...**...**.....**********
***...........*...............*...*...****....*...*......**********
***...........**.***............*****.***.....*...***...***********
***...**.......*****.............*....*......***......>....********
****..****.....*****.......***...**...............***.....*********
*******************************************************************
