*******************************************************************
****.......*..**....................********..........*.....*******
*.**..........***....................*******...................*..*
*..............................**.....*.****.....**.........>.....*
*.........****....**..........*.........*...*....**..............**
**....*...*****...**.....*........***..***.....*****..*....*......*
**......*.*****............*.*....****.**.....****....******....***
****......*...*......*...............*....*....***.....*****....*.*
*..*......**.........**..............*....*.....*........***.*....*
*..........**.<....*****..................**..............**.***.**
**........***********........................................******
*****.***...***********................*.*...*****...........******
*...*.*.*.*...*********.*......****......*...*****.*****.....******
*.............********..**.....***.*....**.....*.*****.*.**.*******
*.*.....*.....********..*.....****.....*****.......***....*********
*****..***.....**********.*.*..***.*****.****......***....******..*
*****........*.************.*...********...***.....****......***..*
*.***........*.***********..........***.....****.............*....*
*.**........********..****...........**.....***............*.*...**
*.*............*****....**...**.......*..........*...............**
*..........**..*****.....*...***..**..*..........*...***.......****
*......*****.*******......*****..*....*****.....**....******....***
*......****...............****...*.*.***..***......**...****...****
*....*.***........*....*******...*...****........******.........***
*......****.*******.*********.........***.....******.**.....*...***
*....*.*...******....*******....***....**..*...****..**.....*...***
*..******..*****...***.....**.*.*......****....*****.***.......****
*..****.....*..*...**...**..*.*........***.....****..**.........***
*.....*...****......**...................................**.....***
*...............***.**...**........*.................*...****.....*
*...*........*..*....*....**.......**.....*....*.....*********....*
*.............***........**......****...*...........**********.*..*
*....*..***..***.....**.......*.....*.....*.....**...*******.***..*
*....*.****...*......**...*.*.***.***.*.***......**...******.***.**
*....*...*...........***..*******.....****.......***..****...**...*
*............*.*...........***************............***........**
*.......*.....****.....**...**************....*.....***...**....***
*******************************************************************
