*******************************************************************
*....****....***..*.***..............****.........*...******.***.**
*.....***...***.*.*..***.....****....***..........*...****.*......*
*..*..*.....***.......**......****..***........*****....**..<.*...*
**.*..*..............***......*********.....*..******.....***.....*
***...***.*.....*......*......************..........**.....**.....*
**......******.........***.**.************..........*.............*
***.....******.........**......**********....**.....**..........***
*........*****...*......****...*.********...****....*..........**.*
*..............*.............*...*****.**...***.....****...*....*.*
*..............***..***..>...*...**.....*.*****.......****.*......*
*.....*..........*...***...................****......****.........*
**..***......***.....***...................*****......***.........*
**....*.....*****....***.*...**.....****..******.................**
***.*.....*****.*....*...**..........***...*******....**.......*..*
***.......*.*...******.......****.....**...***..**...***....****..*
*.***.**....**..*******.....*******...**....**..**...***.........**
*..*****.........*...........***********....*.*...*****...........*
*..******....**...........******.*.***...*.......................**
*..*******...**.....**......**.......*...***.......***......***...*
*..*...****...*.....**......**...........*...............*.*.*....*
*......***...*....***......***.....***...**..............*.......**
*..*........**....***..*..***......**......*....*.***....**......**
*.*****......*............***...........*....*....................*
*.******....**...........*.......**.......................*......**
********...***...*......**...******...................*.***.***.***
*******....****.***....***..****.*........***....*.*..***.*.*******
**.**........******.....***.**.......**.*.*.*....****.**...********
**............****...*******.....**.....*.*.*.........*.....*******
***..*...**.....***...*..**.....***...****............**....*******
***..*...........******...*.............***..****...****..*.*******
*...*******.....*****...................*...******..****..*...*****
*.*.****....**********.................***..***..*******......*****
*.***..********.*...................****.............***........***
*.***..*******....*........***...*......**............*.......*****
*......*******....*....*.*.***...*********..***.***...........*****
*.*...********....*...***..*****.*******...*********..****...******
*******************************************************************
