*******************************************************************
*.*.**...<.......************...**....*...*.**..*******************
*....****......*****.*********..**.................****************
*....***.......**.....*********..*....***..........**.*************
*.....**.**.....*.....*....****.***..>.**..........**..************
**....**...*....**..........***........******......**.*.***********
*.....*......******.........******......***.*............**********
**..........***..**.*.***.********........*.........*.....*********
*.........*.**............*******.*......*..........**.***.********
*.....*...***....*.......********..........*....*.*.**.*....*******
**...***...**....*.......*.******.............***..**.......*******
***................*.*.*.....*.**............****.***.....*.*******
****........*****..******.*....***..........****...**.....*********
***....**....****..*....*...*********.......***....**...***********
***....*......***.*.......*..**********.....***.*.......***********
***...*...................*****...*****..********.....*************
***.....*...................**....****...********....**************
*....**.******.......**..........*****..*********......************
*...****.***.......*.*..**.......****...****...........************
*..****..***.**...****..***....******..*****...........************
*..***.*.*.*..*.*.*********....******...****..........*************
*...**......*********...**.....******....****.......***************
******.*.*.**********..........****.......***..**...***************
*****......******..*..........****........***.**...****************
****....****.****.............***...***...***....*...**************
****..................*..*.....*..****...........**....************
****...*...*..*.**......***....**..***..........***....************
***....*...***..**.....***.....*....*......*...****....************
***...*.....**...***.*.***.....................***.*...************
*****.*............***.*..........***...............*..*.**********
*********..........****.......*.****..............***....**********
*****.****...**....***........***...*......*......***.*************
****...***...*.*******.........**.....*****.....*******************
****...***...*.*..****.........***....***....**********************
*****..........*.....*..............*.***....**********************
*******.......**.....*.*.........******.......*********************
*****...***..***.........*.......***........***********************
*******************************************************************
