*******************************************************************
**.*.....******.........*..********...*.***......*...**************
**.....*.*.*****...........*****.....*.............*.**************
****.......***.........********........................************
*****...*..*****.**.....*******.........................*****..****
**........*****..**....***..............****........*..*******...**
**....*....****..**....*.***...*........****.......****..*.*......*
*...***..*.****.****...*.*.....**.......***......*.****....*......*
**...*...**********....*.*.*..*****........*.....*..............*.*
****.....***.***...........*....*........*.***...*...............**
****.***.***..*....**..****..............*****...***.......*......*
********.....****...*...*****....*.**...*****...***......***.....**
********.*......*****...**......*****.........*******....***....***
********.*........***..*****...*.****...*....********.....***..****
****..****.......***.******....*...*....***..*****.*.......********
****..***......*.....*****.*...*...*....****...***....*...*********
***...***...****...*******.....*....*..******...***.......*********
*.......**..*.......****....*.....****.******....**.......*********
*.*...****..........**.......*.*.****..******....***......*********
*.*.....*.........*.....*....*.*.****.*****.....*****.....*********
*.*...***.....**.****..*...........**..*****....***.......*..******
*.*...**......******...**............*.*****....***..........******
*......*......**..**.........*....********.***.................****
**....**..**..*..***.....*...*..**..****...**...*.*..****.....*****
*.....**...**.....**....****.........***...***.......*****.....****
*..........***......*.**...*.........**.............******...******
*.......*..***.*...**.**.*****......****.......*...*******...******
*.*...***......*.*.****...******.*....*............**.**.....******
***....**.......********...**.*****.*.*********..**...***...*******
*......*........********....*...****....*******......*****.********
*......*.....*.*********.*........**....*********...***************
*......*.....*.*********.**..*.*..*......******.....***************
*..*..***.......*******...*...***....***.*******.....**************
**....***.****.....****...*.*...***....*****.........**************
**....***..***............***...**....*******....******************
*......*................*...*..........*******...******************
*................*.....***.....*.....**********...*****************
*******************************************************************
